Always Already New: Lisa Gitelman
Always On: Language in and Online and Mobile World: Naomi Baron
Blogging: Jill Walker Re\burg
Blog Theory: Jodi Dean
The Breakup 2.0: Ilana Gershon
Convergence Culture:Henry Jenkins
Copyrights and Copywrongs: Siva Vaidhyanathan Cri9cal Perspec9ves on the Internet: Greg Elmer et. al.
Cyberprotest: Jenny Pickerill
Cyberfeminism 2.0: Radhika Gajjala
Cybertext: Espen Aarseth
Designing Culture: Anne Balsamo
Digital Media and Democracy: Megan Boler
Digital Media Ethics: Charles Ess
The Digital Origins of Dictatorship and Democracy: Philip Howard
Digi9zing Race: Lisa Nakamura
Divining a Digital Future: Paul Dourish
The Exploit: Alexander Galloway and Eugene Thacker
Free Culture: Lawrence Lessig
Future Ac9ve: Media Ac9vism and the Internet: Graham Meikle
The Future of the Internet: Jonathan Zi\rain Games of Empire: Nick Dyer-Witherford and Greg de Peuter
Gamer Theory: Mackenzie Wark
Good Faith Collabora9on: The Culture of Wikipedia: Joseph Reagle
The Googliza9on of Everything: Siva Vaidhyanathan
Governing Global Electronic Networks: William Drake
Hypertext 3.0: Cri9cal Theory and New Media: George P. Landow
Life on the Screen: Sherry Turkle
Hanging out, Messing Around, and Geeking Out: Mitzuko Ito, et. al.
How to Think about Informa9on: Dan Schiller
The Informa9on Bomb: Paul Virilio
The Informa9onal City: Manuel Castells
The Informa9on Society: Armand Ma\elart
The Informa9on Society: Cyber Dreams and Digital Nightmares: Robert Hassan
Interna9onal Handbook of Internet Research: Jeremy Hunsinger, Lisbeth Klastrup, and Ma\hew Allen
The Internet: an ethnographic approach: Daniel Miller
Internet Inquiry: Anne\e Markham and Nancy Baym
Internet Inven9on: From Literacy to Electracy: Gregory Ulmer
Interop: The Promise and Peril of Highly Interconnected Systems: John Palfrey and Urs Gasser
In the Plex: How Google Thinks....: Steven Levy Inven9ng the Internet: Janet Abbate
iSpy: Surveillance and Power in the Interac9ve Era: Mark Andrejevic
Learning and Research in Virtual Worlds: Jeremy Hunsinger and Aleks Krotoski
Linqua Fracta: Toward a Rhetoric of New Media Collin Brooke
Mechanisms: New Media and the Forensic Imagina9on: Ma\hew Kirschenbaum
The Moment of Complexity: Mark C. Taylor
MP3: The Meaning of a Format: Jonathan Sterne My Life as a Night Elf Priest: Bonnie Nardi
The Myth of Digital Democracy: Mathew Hindman The Net Effect: Thomas Streeter
Net Work: Ethics and Values in Web Design: Helen Kennedy
Network Culture: Tiziana Terranova
Networked: Lee Rainie and Barry Wellman Networks and States: The Global Poli9cs of Internet Governance: Milton Mueller
Networks of Outrage and Hope: Manuel Castells New Media Reader: Noah Waldrip-Fruin
Online A Lot of the Time: Ken Hillis
Opening Standards: Laura DeNardis
Organized Networks: Media Theory, Crea9ve Labor, New Ins9tu9ons: Ned Rossiter
The Penguin and the Leviathan: Yochai Benkler Play Between Worlds: T. L. Taylor
Play Money: Julian Dibbell
The Postmodern Condi9on: Jean-Francois Lyotard Preemp9ng Dissent: The Poli9cs of an Inevitable Future: Greg Elmer and Andy Opei
A Private Sphere Zizi Papacharisi
Profiling Machines: Greg Elmer
Protocol: Alexander Galloway
Protocol Poli9cs: Laura DeNardis
Race afer the Internet: Lisa Nakamura and Peter Chow-White
Radiant Textuality: Jerome Mcgann
Reading Youtube: Anandam Kavoori
Reload: Rethinking Women and Cyberculture: MaryFlanagan
Remedia9on: Jay David Bolter and Richard Grusin Rise of the Networked Society: Manuel Castells Routledge Handbook of Internet Poli9cs: Andrew Chadwick and Philip Howard
Ruling the Root: Milton Mueller
Scholarship in the Digital Age: Chris9ne Borgman Screens of Power: Timothy W. Luke
Search Engine Society: Alexander Halavais Simulacra and Simula9on: Jean Baudrillard
The Social Media Reader: Michael Mandiberg
The Social Life of Informa9on: John Seely Brown and Paul Duguid
The Spam Book: Jussi Parikka
Splintered Urbanism: Steve Graham
Standards and their Stories: Susan Leigh Starr Standards: Recipes for Infrastructures: Lawrence Busch
Synthe9c Worlds: Ed Castronova
Tales from Facebook: Daniel Miller
Theories of the Informa9on Society:
Webster
Tubes: A Journey to the Center of the Intenret:
Andrew Blum
Understanding Digital Humani9es: David Berry
Venture Labor: Gina Neff
